#########..........................................................##########
#...........................................................................#
#................................#................#.........................#
#................................#................#..........................
.................................#................#..........................
.....................#############................############...............
.............................................................................
........................................####.................................
........................................####.................................
........................................####.................................
...........................................................................
.....................#############................############...............
.................................#................#..........................
.................................#................#..........................
.................................#................#..........................
.............................................................................
#...........................................................................#
#...........................................................................#
#...........................................................................#
#########...........................................................#########
